  ####
  #  #
###$ ##
# $  @#
# ... #
##$  ##
 #  ##
 ####