#####
#.  ##
#@$$ #
##   #
 ##  #
  ## #
   #.#
   ###